丟	丟
並	並
乗	乘
乹	乾
亁	乾
亂	亂
亙	亙
亞	亞
亯	享
亱	夜
亷	廉
亾	亡
伕	夫
佀	似
佇	佇
佈	布
佔	佔
併	並
來	來
侖	侖
侶	侶
侷	局
俁	俁
係	系
俛	俯
俠	俠
倀	倀
倆	倆
倉	倉
個	個
倐	倏
們	們
倖	幸
倣	仿
倫	倫
倸	睬
偉	偉
偘	侃
偪	逼
側	側
偵	偵
偸	偷
偺	咱
偽	僞
傑	傑
傖	傖
傘	傘
備	備
傚	效
傢	家
傭	傭
傯	傯
傳	傳
傴	傴
債	債
傷	傷
傾	傾
僂	僂
僅	僅
僉	僉
僊	仙
僑	僑
僕	僕
僞	僞
僥	僥
僨	僨
僱	僱
價	價
儀	儀
儁	俊
儂	儂
億	億
儅	當
儈	儈
儉	儉
儐	儐
儔	儔
儕	儕
儘	盡
償	償
優	優
儲	儲
儵	倏
儷	儷
儸	羅
儹	攢
儺	儺
儻	儻
儼	儼
兇	兇
兌	兌
兎	兔
兒	兒
兗	兗
兠	兜
內	內
兩	兩
冄	冉
冊	冊
冐	冒
冪	冪
冺	泯
凃	塗
凍	凍
凜	凜
凟	瀆
凣	凡
処	處
凱	凱
凴	憑
別	別
刦	劫
刧	劫
刪	刪
刼	劫
剄	剄
則	則
剋	克
剛	剛
剝	剝
剮	剮
剳	札
剴	剴
創	創
剷	鏟
剹	戮
劃	劃
劄	札
劇	劇
劉	劉
劊	劊
劌	劌
劍	劍
劑	劑
劒	劍
効	效
勁	勁
勅	敕
勌	倦
動	動
勗	勖
務	務
勛	勳
勝	勝
勞	勞
勢	勢
勣	績
勦	剿
勱	勱
勳	勳
勵	勵
勸	勸
勻	勻
匃	丐
匄	丐
匟	炕
匭	匭
匯	匯
匱	匱
匲	奩
匳	奩
匵	櫝
區	區
協	協
卹	恤
卻	卻
厀	膝
厙	厙
厛	廳
厠	廁
厤	歷
厭	厭
厰	廠
厲	厲
厴	厴
參	參
叡	睿
叢	叢
吚	咿
吳	吳
呂	呂
呌	叫
呪	咒
咊	和
咼	咼
員	員
哢	咔
哶	咩
唄	唄
唕	唣
唚	吣
唫	吟
唸	念
啎	忤
問	問
啑	喋
啓	啓
啗	啖
啞	啞
啟	啓
啣	銜
喆	哲
喒	咱
喚	喚
喦	巖
喪	喪
喫	喫
喬	喬
單	單
喲	喲
嗁	啼
嗆	嗆
嗇	嗇
嗎	嗎
嗚	嗚
嗩	嗩
嗶	嗶
嘅	慨
嘆	嘆
嘍	嘍
嘑	呼
嘔	嘔
嘖	嘖
嘗	嘗
嘜	嘜
嘠	嘎
嘩	譁
嘮	嘮
嘯	嘯
嘰	嘰
嘵	嘵
嘸	嘸
噁	惡
噅	咴
噉	啖
噓	噓
噝	噝
噠	噠
噥	噥
噦	噦
噯	噯
噲	噲
噴	噴
噸	噸
噹	當
嚀	嚀
嚇	嚇
嚌	嚌
嚐	嘗
嚕	嚕
嚙	齧
嚥	咽
嚦	嚦
嚨	嚨
嚮	向
嚳	嚳
嚴	嚴
嚶	嚶
嚻	囂
囀	囀
囁	囁
囂	囂
囅	囅
囈	囈
囌	蘇
囑	囑
囘	回
囙	因
囪	囪
囬	回
囯	國
圅	函
圇	圇
國	國
圍	圍
園	園
圓	圓
圖	圖
團	團
坰	垧
坵	丘
坿	附
垜	垛
垵	埯
垻	壩
埛	炯
埜	野
埡	埡
埰	採
埳	坎
執	執
堃	坤
堅	堅
堊	堊
堖	堖
堘	塍
堝	堝
堦	階
堯	堯
報	報
場	場
堿	鹼
塊	塊
塋	塋
塏	塏
塒	塒
塗	塗
塚	冢
塟	葬
塢	塢
塤	壎
塲	場
塵	塵
塹	塹
塼	磚
墊	墊
墖	塔
墜	墜
墝	磽
墪	墩
墮	墮
墰	壇
墳	墳
墻	牆
墾	墾
壄	野
壇	壇
壎	壎
壓	壓
壘	壘
壙	壙
壚	壚
壜	壇
壞	壞
壟	壟
壠	壟
壢	壢
壩	壩
壯	壯
壺	壺
壻	婿
壽	壽
夀	壽
夘	帽
夠	夠
夢	夢
夾	夾
奐	奐
奧	奧
奩	奩
奪	奪
奮	奮
妝	妝
妬	妒
妳	你
妷	侄
姉	姊
姍	姍
姙	妊
姦	奸
姪	侄
娛	娛
娬	嫵
娿	婀
婁	婁
婦	婦
婬	淫
婭	婭
媧	媧
媮	偷
媯	嬀
媼	媼
媽	媽
媿	愧
嫋	嫋
嫗	嫗
嫰	嫩
嫵	嫵
嫺	嫺
嫻	嫺
嬀	嬀
嬈	嬈
嬋	嬋
嬌	嬌
嬙	嬙
嬝	嫋
嬡	嬡
嬤	嬤
嬪	嬪
嬭	奶
嬰	嬰
嬸	嬸
嬾	懶
孃	娘
孌	孌
孫	孫
學	學
孼	孽
孿	孿
宂	冗
宮	宮
宼	寇
寀	採
寘	置
寢	寢
實	實
寧	寧
審	審
寫	寫
寬	寬
寵	寵
寶	寶
尅	克
將	將
專	專
尋	尋
對	對
導	導
尲	尷
尷	尷
屆	屆
屍	屍
屜	屜
屢	屢
層	層
屨	屨
屬	屬
岅	坂
岡	岡
峝	峒
峩	峨
峯	峯
峴	峴
島	島
峽	峽
崍	崍
崐	昆
崑	昆
崗	崗
崙	侖
崠	崬
崢	崢
崬	崬
崳	嵛
嵐	嵐
嵗	歲
嶁	嶁
嶄	嶄
嶇	嶇
嶗	嶗
嶠	嶠
嶧	嶧
嶴	岙
嶸	嶸
嶺	嶺
嶼	嶼
嶽	嶽
巋	巋
巒	巒
巔	巔
巖	巖
巗	巖
巰	巰
巵	卮
巹	巹
帀	匝
帥	帥
師	師
帬	裙
帳	帳
帶	帶
幀	幀
幃	幃
幑	徽
幗	幗
幘	幘
幙	幕
幟	幟
幣	幣
幫	幫
幬	幬
幹	幹
幾	幾
庫	庫
庻	庶
廁	廁
廂	廂
廄	廄
廈	廈
廐	廄
廕	蔭
廚	廚
廝	廝
廟	廟
廠	廠
廡	廡
廢	廢
廣	廣
廩	廩
廬	廬
廳	廳
廵	巡
廹	迫
廻	回
廼	乃
弔	吊
弳	弳
張	張
強	強
彆	別
彈	彈
彊	強
彌	彌
彎	彎
彙	匯
彜	彝
彞	彝
彥	彥
彫	雕
彿	佛
徃	往
徑	徑
從	從
徠	徠
復	復
徬	仿
徴	徵
徹	徹
怱	匆
怳	恍
恆	恆
恠	怪
恡	吝
恥	恥
悅	悅
悤	匆
悳	德
悵	悵
悶	悶
悽	悽
惏	婪
惡	惡
惥	恿
惱	惱
惲	惲
惻	惻
愛	愛
愜	愜
愨	愨
愴	愴
愷	愷
愽	博
愾	愾
慂	恿
慄	慄
慇	殷
態	態
慍	慍
慘	慘
慙	慚
慚	慚
慟	慟
慣	慣
慤	愨
慪	慪
慫	慫
慮	慮
慳	慳
慴	懾
慶	慶
慼	戚
慾	欲
憂	憂
憇	憩
憊	憊
憐	憐
憑	憑
憒	憒
憚	憚
憤	憤
憫	憫
憮	憮
憲	憲
憶	憶
懃	勤
懇	懇
應	應
懌	懌
懍	懍
懕	懨
懞	蒙
懟	懟
懣	懣
懨	懨
懲	懲
懶	懶
懷	懷
懸	懸
懺	懺
懼	懼
懽	歡
懾	懾
戀	戀
戇	戇
戔	戔
戧	戧
戩	戩
戱	戲
戰	戰
戲	戲
戶	戶
戹	厄
戼	帽
扡	扦
拏	拿
拕	拖
挐	拿
挱	挲
挾	挾
挿	插
捄	救
捨	舍
捫	捫
捲	卷
掃	掃
掄	掄
掙	掙
掛	掛
採	採
掽	碰
揀	揀
揑	捏
揚	揚
換	換
揫	揪
揮	揮
揹	背
搆	構
搇	撳
搉	榷
損	損
搖	搖
搗	搗
搥	捶
搨	拓
搯	掏
搶	搶
搾	榨
摑	摑
摜	摜
摟	摟
摣	揸
摯	摯
摳	摳
摶	摶
摻	摻
撈	撈
撐	撐
撓	撓
撚	捻
撟	撟
撡	操
撣	撣
撥	撥
撦	扯
撫	撫
撲	撲
撳	撳
撻	撻
撾	撾
撿	撿
擁	擁
擄	擄
擇	擇
擊	擊
擋	擋
擔	擔
擕	攜
據	據
擠	擠
擡	抬
擣	搗
擧	舉
擬	擬
擯	擯
擰	擰
擱	擱
擲	擲
擴	擴
擷	擷
擺	擺
擻	擻
擼	擼
擾	擾
攄	攄
攆	攆
攏	攏
攔	攔
攖	攖
攙	攙
攛	攛
攜	攜
攝	攝
攢	攢
攣	攣
攤	攤
攩	擋
攪	攪
攬	攬
攷	考
敂	叩
敍	敘
敗	敗
敘	敘
敭	揚
敵	敵
數	數
敺	驅
斂	斂
斃	斃
斕	斕
斬	斬
斮	斫
斲	斫
斵	斫
斷	斷
旂	旗
旾	春
昇	升
昬	昏
昰	是
時	時
晉	晉
晝	晝
晳	晰
晻	暗
暈	暈
暉	暉
暎	映
暠	皓
暢	暢
暫	暫
暱	暱
曄	曄
曆	歷
曇	曇
曉	曉
曏	向
曖	曖
曠	曠
曡	疊
曬	曬
書	書
會	會
朢	望
朧	朧
朶	朵
東	東
枏	楠
枒	丫
枴	拐
柟	楠
柵	柵
柹	柿
柺	拐
査	查
栁	柳
桮	杯
桺	柳
桿	杆
梔	梔
梘	梘
條	條
梟	梟
梱	捆
棃	梨
棄	棄
棊	棋
棖	棖
棗	棗
棟	棟
棧	棧
棬	桊
棲	棲
椀	碗
椏	椏
椗	碇
椶	棕
楊	楊
楓	楓
楥	楦
楨	楨
業	業
楳	梅
極	極
榦	幹
榪	榪
榮	榮
榿	榿
槀	稿
槃	盤
構	構
槍	槍
槑	梅
槓	槓
槕	桌
槧	槧
槨	槨
槩	概
槳	槳
槼	規
樁	樁
樂	樂
樅	樅
樑	梁
樓	樓
標	標
樞	樞
樣	樣
樷	叢
樸	樸
樹	樹
樺	樺
橈	橈
橋	橋
橜	橛
機	機
橢	橢
橤	蕊
橫	橫
橰	槔
檁	檁
檉	檉
檔	檔
檜	檜
檝	楫
檢	檢
檣	檣
檯	臺
檳	檳
檸	檸
檻	檻
檾	苘
櫂	棹
櫃	櫃
櫈	凳
櫓	櫓
櫚	櫚
櫛	櫛
櫝	櫝
櫞	櫞
櫟	櫟
櫥	櫥
櫧	櫧
櫨	櫨
櫪	櫪
櫫	櫫
櫬	櫬
櫳	櫳
櫸	櫸
櫺	欞
櫻	櫻
欄	欄
權	權
欏	欏
欑	攢
欒	欒
欖	欖
欞	欞
欬	咳
欵	款
欽	欽
歎	嘆
歐	歐
歗	嘯
歛	斂
歟	歟
歡	歡
歲	歲
歷	歷
歸	歸
歿	歿
殀	夭
殘	殘
殞	殞
殤	殤
殫	殫
殭	僵
殮	殮
殯	殯
殲	殲
殺	殺
殼	殼
毀	毀
毆	毆
毉	醫
毘	毗
毧	絨
毬	球
毿	毿
氂	犛
氈	氈
氊	氈
氌	氌
氣	氣
氫	氫
氬	氬
氳	氳
氷	冰
氹	凼
氾	泛
汎	泛
汙	污
汚	污
決	決
沍	冱
沒	沒
沖	衝
況	況
泝	溯
洩	泄
洶	洶
浹	浹
涇	涇
涖	蒞
涼	涼
淒	悽
淚	淚
淛	浙
淥	淥
淨	淨
淩	凌
淪	淪
淵	淵
淶	淶
淺	淺
渙	渙
減	減
渦	渦
測	測
渾	渾
湊	湊
湞	湞
湣	愍
湧	湧
湯	湯
湻	淳
溈	潙
準	準
溝	溝
溫	溫
溼	溼
滄	滄
滅	滅
滌	滌
滎	滎
滙	匯
滛	淫
滬	滬
滯	滯
滲	滲
滷	滷
滸	滸
滾	滾
滿	滿
漁	漁
漚	漚
漢	漢
漣	漣
漬	漬
漲	漲
漵	漵
漸	漸
漿	漿
潁	潁
潄	漱
潑	潑
潔	潔
潙	潙
潛	潛
潟	舄
潤	潤
潯	潯
潰	潰
潷	潷
潿	潿
澀	澀
澁	澀
澂	澄
澆	澆
澇	澇
澗	澗
澠	澠
澤	澤
澩	澩
澮	澮
澱	澱
濁	濁
濃	濃
濕	溼
濘	濘
濛	蒙
濟	濟
濤	濤
濫	濫
濬	浚
濰	濰
濱	濱
濶	闊
濺	濺
濼	濼
濾	濾
瀅	瀅
瀆	瀆
瀉	瀉
瀋	瀋
瀏	瀏
瀕	瀕
瀘	瀘
瀝	瀝
瀟	瀟
瀠	瀠
瀦	瀦
瀧	瀧
瀨	瀨
瀰	彌
瀲	瀲
瀾	瀾
灃	灃
灄	灄
灋	法
灑	灑
灕	漓
灘	灘
灝	灝
灣	灣
灤	灤
灧	灩
灩	灩
災	災
炤	照
為	為
烏	烏
烖	災
烴	烴
無	無
煆	煅
煇	輝
煉	煉
煑	煮
煒	煒
煖	暖
煗	暖
煙	煙
煢	煢
煥	煥
煩	煩
煬	煬
熒	熒
熗	熗
熱	熱
熾	熾
燁	燁
燄	焰
燈	燈
燉	燉
燐	磷
燒	燒
燙	燙
燜	燜
營	營
燦	燦
燬	毀
燭	燭
燴	燴
燻	燻
燼	燼
燾	燾
燿	耀
爍	爍
爐	爐
爗	燁
爛	爛
爭	爭
為	為
爺	爺
爾	爾
牀	牀
牆	牆
牋	箋
牎	窗
牐	閘
牓	榜
牕	窗
牘	牘
牠	它
牴	抵
牽	牽
犂	犁
犇	奔
犖	犖
犛	犛
犢	犢
犧	犧
狀	狀
狥	徇
狹	狹
狽	狽
猂	悍
猙	猙
猨	猿
猶	猶
猻	猻
獁	獁
獃	呆
獄	獄
獅	獅
獋	嗥
獎	獎
獘	弊
獧	狷
獨	獨
獪	獪
獫	獫
獰	獰
獲	獲
獵	獵
獷	獷
獸	獸
獺	獺
獻	獻
獼	獼
玀	玀
玅	妙
玆	茲
玨	珏
珎	珍
珮	佩
現	現
琍	璃
琯	管
琱	雕
琹	琴
琺	琺
琿	琿
瑉	珉
瑋	瑋
瑠	琉
瑣	瑣
瑤	瑤
瑩	瑩
瑪	瑪
瑯	琅
璉	璉
璢	琉
璣	璣
璦	璦
環	環
璽	璽
璿	璇
瓈	璃
瓊	瓊
瓌	瑰
瓏	瓏
瓔	瓔
瓚	瓚
甌	甌
甎	磚
甕	甕
甖	罌
產	產
産	產
甦	蘇
畊	耕
畝	畝
畢	畢
畧	略
畫	畫
異	異
畱	留
當	當
疇	疇
疉	疊
疊	疊
疎	疏
疘	肛
疿	痱
痐	蛔
痙	痙
痠	酸
痳	淋
痺	痹
痾	痾
瘂	瘂
瘉	愈
瘋	瘋
瘍	瘍
瘓	瘓
瘖	喑
瘞	瘞
瘡	瘡
瘧	瘧
瘺	瘻
瘻	瘻
療	療
癄	憔
癅	瘤
癆	癆
癇	癇
癉	癉
癒	愈
癘	癘
癟	癟
癡	癡
癢	癢
癤	癤
癥	症
癧	癧
癩	癩
癬	癬
癭	癭
癮	癮
癰	癰
癱	癱
癲	癲
發	發
皁	皁
皚	皚
皜	皓
皰	皰
皷	鼓
皸	皸
皺	皺
盃	杯
盇	盍
盌	碗
盜	盜
盞	盞
盡	盡
監	監
盤	盤
盧	盧
盪	蕩
眎	視
眡	視
眥	眥
眾	衆
睏	困
睜	睜
睞	睞
睠	眷
瞇	眯
瞖	翳
瞘	瞘
瞞	瞞
瞼	瞼
矁	瞅
矇	蒙
矙	瞰
矚	矚
矯	矯
矴	碇
砲	炮
硃	朱
硤	硤
硨	硨
硯	硯
硶	磣
碁	棋
碩	碩
碪	砧
碭	碭
碸	碸
確	確
碼	碼
磚	磚
磣	磣
磧	磧
磯	磯
磽	磽
礎	礎
礙	礙
礦	礦
礪	礪
礫	礫
礬	礬
礮	炮
礱	礱
祐	佑
祑	帙
祕	祕
祿	祿
禍	禍
禎	禎
禦	御
禩	祀
禪	禪
禮	禮
禰	禰
禱	禱
禿	禿
秈	秈
秌	秋
稅	稅
稈	稈
稜	棱
稟	稟
稭	秸
種	種
稱	稱
稺	稚
穀	谷
穅	糠
穉	稚
穌	穌
積	積
穎	穎
穡	穡
穢	穢
穨	頹
穩	穩
穫	獲
穭	穭
穽	阱
窓	窗
窩	窩
窪	窪
窮	窮
窯	窯
窰	窯
窶	窶
窺	窺
竄	竄
竅	竅
竇	竇
竈	竈
竊	竊
竚	佇
竝	並
竢	俟
竪	豎
競	競
筆	筆
筍	筍
筞	策
筦	管
筧	筧
筩	筒
筯	箸
筴	策
箇	個
箋	箋
箏	箏
箒	帚
箠	棰
節	節
範	範
築	築
篋	篋
篛	箬
篠	筱
篤	篤
篩	篩
篳	篳
篹	纂
簀	簀
簍	簍
簑	蓑
簒	篡
簞	簞
簡	簡
簣	簣
簫	簫
簮	簪
簷	檐
簽	籤
簾	簾
籃	籃
籌	籌
籐	藤
籜	籜
籟	籟
籠	籠
籢	奩
籤	籤
籥	鑰
籩	籩
籪	籪
籬	籬
籮	籮
籲	籲
粃	秕
粇	糠
粦	磷
粧	妝
粬	曲
粰	麩
粵	粵
粺	稗
糉	糉
糝	糝
糞	糞
糢	模
糧	糧
糰	團
糲	糲
糴	糴
糶	糶
糾	糾
紀	紀
紂	紂
約	約
紅	紅
紆	紆
紇	紇
紈	紈
紉	紉
紋	紋
納	納
紐	紐
紓	紓
純	純
紕	紕
紗	紗
紙	紙
級	級
紛	紛
紜	紜
紡	紡
紥	扎
紮	扎
細	細
紱	紱
紲	紲
紳	紳
紹	紹
紺	紺
紼	紼
紿	紿
絀	絀
終	終
絃	弦
組	組
絆	絆
絎	絎
絏	紲
結	結
絕	絕
絛	絛
絝	絝
絞	絞
絡	絡
絢	絢
給	給
絨	絨
統	統
絲	絲
絳	絳
絹	絹
綁	綁
綃	綃
綆	綆
綈	綈
綉	繡
綏	綏
綑	捆
經	經
綜	綜
綞	綞
綠	綠
綢	綢
綣	綣
綫	線
綬	綬
維	維
綰	綰
綱	綱
網	網
綳	繃
綴	綴
綵	彩
綸	綸
綹	綹
綺	綺
綻	綻
綽	綽
綾	綾
綿	綿
緄	緄
緇	緇
緊	緊
緋	緋
緍	緡
緐	繁
緒	緒
緔	鞝
緗	緗
緘	緘
緙	緙
線	線
緜	綿
緝	緝
緞	緞
締	締
緡	緡
緣	緣
緤	紲
緥	褓
緦	緦
編	編
緩	緩
緬	緬
緯	緯
緱	緱
緲	緲
練	練
緶	緶
緹	緹
緻	致
縂	總
縈	縈
縉	縉
縊	縊
縋	縋
縐	縐
縑	縑
縚	絛
縛	縛
縝	縝
縞	縞
縟	縟
縣	縣
縧	絛
縫	縫
縭	縭
縮	縮
縯	演
縱	縱
縲	縲
縴	纖
縵	縵
縶	縶
縷	縷
縹	縹
總	總
績	績
繃	繃
繅	繅
繆	繆
繈	襁
繒	繒
織	織
繕	繕
繖	傘
繙	翻
繚	繚
繞	繞
繡	繡
繢	繢
繦	襁
繩	繩
繪	繪
繫	系
繭	繭
繮	繮
繯	繯
繰	繰
繳	繳
繹	繹
繼	繼
繽	繽
繾	繾
纈	纈
纊	纊
續	續
纍	累
纏	纏
纓	纓
纖	纖
纘	纘
纜	纜
缽	鉢
缾	瓶
罇	樽
罈	壇
罋	甕
罌	罌
罎	壇
罏	壚
罰	罰
罵	罵
罷	罷
罸	罰
羅	羅
羆	羆
羈	羈
羋	羋
羗	羌
羢	絨
羣	羣
羥	羥
羨	羨
義	義
羶	羶
習	習
翫	玩
翶	翱
翹	翹
翺	翱
耑	端
耡	鋤
耬	耬
耮	耮
聖	聖
聞	聞
聯	聯
聰	聰
聲	聲
聳	聳
聵	聵
聶	聶
職	職
聹	聹
聼	聽
聽	聽
聾	聾
肅	肅
肎	肯
肐	胳
肧	胚
胷	胸
脃	脆
脅	脅
脇	脅
脈	脈
脗	吻
脛	脛
脣	脣
脩	修
脫	脫
脹	脹
腎	腎
腖	腖
腡	腡
腦	腦
腫	腫
腳	腳
腸	腸
膁	肷
膃	膃
膚	膚
膠	膠
膩	膩
膽	膽
膾	膾
膿	膿
臉	臉
臋	臀
臍	臍
臏	臏
臒	癯
臕	膘
臘	臘
臙	胭
臚	臚
臝	裸
臟	髒
臠	臠
臥	臥
臨	臨
臯	皋
臺	臺
與	與
興	興
舉	舉
舊	舊
舖	鋪
舘	館
舩	船
艕	膀
艙	艙
艢	檣
艣	櫓
艤	艤
艦	艦
艪	櫓
艫	艫
艱	艱
艷	豔
艸	艹
芲	花
芻	芻
薴	苧
茘	荔
茲	茲
荊	荊
荳	豆
莊	莊
莖	莖
莢	莢
莧	莧
菑	災
菓	果
華	華
菴	庵
萇	萇
萊	萊
萬	萬
萲	萱
萵	萵
葉	葉
葒	葒
葠	參
葤	葤
葦	葦
葯	藥
葷	葷
蒐	搜
蒓	蓴
蒔	蒔
蒞	蒞
蒼	蒼
蓀	蓀
蓆	席
蓋	蓋
蓡	參
蓧	莜
蓮	蓮
蓯	蓯
蓴	蓴
蓽	蓽
蔆	菱
蔔	卜
蔕	蒂
蔞	蔞
蔣	蔣
蔥	蔥
蔦	蔦
蔭	蔭
蔴	麻
蔾	藜
蕁	蕁
蕆	蕆
蕋	蕊
蕎	蕎
蕒	蕒
蕓	芸
蕕	蕕
蕘	蕘
蕚	萼
蕢	蕢
蕩	蕩
蕪	蕪
蕭	蕭
蕷	蕷
蕿	萱
薈	薈
薊	薊
薌	薌
薑	姜
薔	薔
薙	剃
薟	薟
薦	薦
薩	薩
薺	薺
藍	藍
藎	藎
藝	藝
藥	藥
藪	藪
藶	藶
藷	薯
藹	藹
藺	藺
藼	萱
蘂	蕊
蘄	蘄
蘆	蘆
蘇	蘇
蘊	蘊
蘋	蘋
蘐	萱
蘚	蘚
蘞	蘞
蘢	蘢
蘤	花
蘭	蘭
蘺	蘺
蘿	蘿
處	處
虖	呼
虛	虛
虜	虜
號	號
虧	虧
虯	虯
虵	蛇
蚘	蛔
蛕	蛔
蛺	蛺
蛻	蛻
蜆	蜆
蜋	螂
蜖	蛔
蜨	蝶
蜺	霓
蝕	蝕
蝟	蝟
蝦	蝦
蝨	蝨
蝯	猿
蝳	玳
蝸	蝸
螄	螄
螎	融
螘	蟻
螞	螞
螡	蚊
螢	螢
螻	螻
蟁	蚊
蟄	蟄
蟇	蟆
蟈	蟈
蟎	蟎
蟣	蟣
蟬	蟬
蟯	蟯
蟲	蟲
蟶	蟶
蟻	蟻
蠅	蠅
蠆	蠆
蠍	蠍
蠏	蟹
蠐	蠐
蠑	蠑
蠔	蠔
蠟	蠟
蠣	蠣
蠱	蠱
蠶	蠶
蠻	蠻
衆	衆
衇	脈
衊	蔑
術	術
衕	同
衖	弄
衚	胡
衛	衛
衝	衝
衞	衛
衹	只
衺	邪
袞	袞
袠	帙
裊	嫋
裌	夾
裏	裏
補	補
裝	裝
裠	裙
裡	裏
裦	褒
製	制
複	復
褲	褲
褳	褳
褸	褸
褻	褻
襆	幞
襇	襉
襍	雜
襖	襖
襝	襝
襠	襠
襢	袒
襤	襤
襪	襪
襯	襯
襲	襲
覇	霸
覈	核
見	見
規	規
覓	覓
覔	覓
視	視
覘	覘
覜	眺
覡	覡
覦	覦
覩	睹
親	親
覬	覬
覯	覯
覰	覷
覲	覲
覷	覷
覺	覺
覻	覷
覽	覽
覿	覿
觀	觀
觔	斤
觕	粗
觝	抵
觴	觴
觶	觶
觸	觸
訁	訁
訂	訂
訃	訃
計	計
訊	訊
訌	訌
討	討
訏	籲
訐	訐
訓	訓
訕	訕
訖	訖
託	託
記	記
訛	訛
訝	訝
訟	訟
訢	欣
訣	訣
訥	訥
訦	諶
訪	訪
設	設
許	許
訴	訴
訶	訶
診	診
註	注
証	證
詁	詁
詆	詆
詎	詎
詐	詐
詒	詒
詔	詔
評	評
詘	詘
詛	詛
詞	詞
詠	詠
詡	詡
詢	詢
詣	詣
試	試
詧	察
詩	詩
詫	詫
詬	詬
詭	詭
詮	詮
詰	詰
話	話
該	該
詳	詳
詵	詵
詶	酬
詼	詼
詿	詿
誄	誄
誅	誅
誆	誆
誇	誇
誌	志
認	認
誑	誑
誒	誒
誕	誕
誖	悖
誘	誘
誚	誚
語	語
誠	誠
誡	誡
誣	誣
誤	誤
誥	誥
誦	誦
誨	誨
說	說
説	說
誰	誰
課	課
誶	誶
誹	誹
誼	誼
調	調
諂	諂
諄	諄
談	談
諉	諉
請	請
諍	諍
諏	諏
諐	愆
諑	諑
諒	諒
論	論
諗	諗
諛	諛
諜	諜
諞	諞
諠	喧
諡	諡
諢	諢
諤	諤
諦	諦
諧	諧
諫	諫
諭	諭
諮	諮
諱	諱
諳	諳
諶	諶
諷	諷
諸	諸
諺	諺
諼	諼
諾	諾
謀	謀
謁	謁
謂	謂
謄	謄
謅	謅
謊	謊
謌	歌
謎	謎
謐	謐
謔	謔
謖	謖
謗	謗
謙	謙
謚	諡
講	講
謝	謝
謠	謠
謨	謨
謫	謫
謬	謬
謳	謳
謹	謹
謼	呼
謾	謾
譁	譁
譆	嘻
證	證
譌	訛
譎	譎
譏	譏
譔	撰
譖	譖
識	識
譙	譙
譚	譚
譜	譜
譟	噪
譫	譫
譭	毀
譯	譯
議	議
譴	譴
護	護
譽	譽
譾	譾
讀	讀
讁	謫
讅	審
變	變
讌	燕
讎	讎
讐	讎
讒	讒
讓	讓
讕	讕
讖	讖
讚	贊
讛	囈
讜	讜
讞	讞
谿	溪
豈	豈
豎	豎
豐	豐
豔	豔
豬	豬
貍	狸
貓	貓
貛	獾
貝	貝
貞	貞
負	負
財	財
貢	貢
貧	貧
貨	貨
販	販
貪	貪
貫	貫
責	責
貯	貯
貰	貰
貲	貲
貳	貳
貴	貴
貶	貶
買	買
貸	貸
貺	貺
費	費
貼	貼
貽	貽
貿	貿
賀	賀
賁	賁
賂	賂
賃	賃
賄	賄
賅	賅
資	資
賈	賈
賉	恤
賊	賊
賍	贓
賑	賑
賒	賒
賓	賓
賔	賓
賕	賕
賚	賚
賛	贊
賜	賜
賞	賞
賠	賠
賡	賡
賢	賢
賣	賣
賤	賤
賦	賦
賧	賧
質	質
賫	齎
賬	賬
賭	賭
賮	贐
賴	賴
賸	剩
賺	賺
賻	賻
購	購
賽	賽
賾	賾
贄	贄
贅	贅
贈	贈
贊	贊
贋	贗
贍	贍
贏	贏
贐	贐
贓	贓
贖	贖
贗	贗
贛	贛
贜	贓
趂	趁
趕	趕
趙	趙
趨	趨
趲	趲
跡	跡
跥	跺
跴	踩
跼	局
踐	踐
踡	蜷
踫	碰
踰	逾
踴	踊
蹌	蹌
蹏	蹄
蹕	蹕
蹚	趟
蹟	跡
蹠	蹠
蹣	蹣
蹤	蹤
蹧	糟
蹵	蹴
蹺	蹺
躉	躉
躊	躊
躋	躋
躍	躍
躑	躑
躒	躒
躓	躓
躕	躕
躚	躚
躡	躡
躥	躥
躦	躦
躪	躪
躰	體
躳	躬
躶	裸
軀	軀
車	車
軋	軋
軌	軌
軍	軍
軒	軒
軔	軔
軛	軛
軟	軟
軤	軤
軫	軫
軲	軲
軸	軸
軹	軹
軺	軺
軻	軻
軼	軼
軾	軾
較	較
輅	輅
輇	輇
載	載
輊	輊
輒	輒
輓	挽
輔	輔
輕	輕
輛	輛
輜	輜
輝	輝
輞	輞
輟	輟
輥	輥
輦	輦
輩	輩
輪	輪
輭	軟
輯	輯
輳	輳
輸	輸
輻	輻
輾	輾
輿	輿
轂	轂
轄	轄
轅	轅
轆	轆
轉	轉
轍	轍
轎	轎
轔	轔
轟	轟
轡	轡
轢	轢
轤	轤
辠	罪
辢	辣
辤	辭
辦	辦
辭	辭
辮	辮
辯	辯
農	農
辳	農
迆	迤
迴	回
迺	乃
迻	移
逈	迥
逕	徑
這	這
連	連
逩	奔
週	周
進	進
遊	遊
運	運
過	過
達	達
違	違
遙	遙
遜	遜
遝	沓
遞	遞
遠	遠
遡	溯
適	適
遯	遁
遲	遲
遷	遷
選	選
遺	遺
遼	遼
邁	邁
還	還
邇	邇
邊	邊
邏	邏
邐	邐
邨	村
郃	合
郟	郟
郤	郄
郵	郵
鄆	鄆
鄉	鄉
鄒	鄒
鄔	鄔
鄕	鄉
鄖	鄖
鄘	墉
鄧	鄧
鄭	鄭
鄰	鄰
鄲	鄲
鄴	鄴
鄶	鄶
鄺	鄺
酈	酈
酧	酬
醃	醃
醕	醇
醞	醞
醜	醜
醞	醞
醫	醫
醬	醬
醻	酬
醼	燕
釀	釀
釁	釁
釃	釃
釅	釅
釋	釋
釐	釐
釓	釓
釔	釔
釕	釕
釗	釗
釘	釘
釙	釙
針	針
釣	釣
釤	釤
釦	扣
釧	釧
釩	釩
釬	焊
釵	釵
釷	釷
釹	釹
釺	釺
鈀	鈀
鈁	鈁
鈄	鈄
鈅	鑰
鈈	鈈
鈉	鈉
鈍	鈍
鈎	鉤
鈐	鈐
鈑	鈑
鈔	鈔
鈕	鈕
鈞	鈞
鈡	鍾
鈣	鈣
鈥	鈥
鈦	鈦
鈧	鈧
鈮	鈮
鈰	鈰
鈳	鈳
鈴	鈴
鈷	鈷
鈸	鈸
鈹	鈹
鈺	鈺
鈽	鈽
鈾	鈾
鈿	鈿
鉀	鉀
鉄	鐵
鉅	鉅
鉆	鑽
鉈	鉈
鉉	鉉
鉋	刨
鉍	鉍
鉑	鉑
鉕	鉕
鉗	鉗
鉚	鉚
鉛	鉛
鉞	鉞
鉢	鉢
鉤	鉤
鉦	鉦
鉬	鉬
鉭	鉭
鉸	鉸
鉺	鉺
鉻	鉻
鉿	鉿
銀	銀
銃	銃
銅	銅
銑	銑
銓	銓
銕	鐵
銖	銖
銘	銘
銚	銚
銜	銜
銠	銠
銣	銣
銥	銥
銦	銦
銨	銨
銩	銩
銪	銪
銫	銫
銬	銬
銱	銱
銲	焊
銳	銳
銷	銷
銹	鏽
銻	銻
銼	銼
鋁	鋁
鋃	鋃
鋅	鋅
鋇	鋇
鋌	鋌
鋏	鋏
鋒	鋒
鋜	鐲
鋝	鋝
鋟	鋟
鋣	鋣
鋤	鋤
鋥	鋥
鋦	鋦
鋨	鋨
鋪	鋪
鋮	鋮
鋯	鋯
鋰	鋰
鋱	鋱
鋶	鋶
鋸	鋸
鋻	鑑
鋼	鋼
錁	錁
錄	錄
錆	錆
錇	錇
錈	錈
錐	錐
錒	錒
錕	錕
錘	錘
錙	錙
錚	錚
錛	錛
錟	錟
錠	錠
錢	錢
錦	錦
錨	錨
錫	錫
錮	錮
錯	錯
錳	錳
錶	表
錸	錸
鍀	鍀
鍁	鍁
鍃	鍃
鍆	鍆
鍇	鍇
鍊	煉
鍋	鍋
鍍	鍍
鍔	鍔
鍘	鍘
鍛	鍛
鍤	鍤
鍥	鍥
鍩	鍩
鍫	鍬
鍬	鍬
鍰	鍰
鍵	鍵
鍶	鍶
鍺	鍺
鍼	針
鍾	鍾
鎂	鎂
鎄	鎄
鎇	鎇
鎊	鎊
鎋	轄
鎖	鎖
鎘	鎘
鎚	錘
鎢	鎢
鎣	鎣
鎦	鎦
鎧	鎧
鎩	鎩
鎪	鎪
鎬	鎬
鎮	鎮
鎰	鎰
鎳	鎳
鎵	鎵
鎸	鐫
鎿	鎿
鏃	鏃
鏇	旋
鏈	鏈
鏌	鏌
鏍	鏍
鏑	鏑
鏗	鏗
鏘	鏘
鏚	戚
鏜	鏜
鏝	鏝
鏞	鏞
鏟	鏟
鏡	鏡
鏢	鏢
鏤	鏤
鏨	鏨
鏵	鏵
鏷	鏷
鏹	鏹
鏽	鏽
鐃	鐃
鐋	鐋
鐐	鐐
鐒	鐒
鐓	鐓
鐔	鐔
鐘	鍾
鐙	鐙
鐝	钁
鐠	鐠
鐦	鐦
鐧	鐧
鐨	鐨
鐫	鐫
鐮	鐮
鐲	鐲
鐳	鐳
鐵	鐵
鐸	鐸
鐺	鐺
鐿	鐿
鑄	鑄
鑊	鑊
鑌	鑌
鑑	鑑
鑒	鑑
鑔	鑔
鑛	礦
鑠	鑠
鑣	鑣
鑤	刨
鑥	鑥
鑪	爐
鑭	鑭
鑰	鑰
鑲	鑲
鑵	罐
鑷	鑷
鑹	鑹
鑼	鑼
鑽	鑽
鑾	鑾
鑿	鑿
钁	钁
長	長
門	門
閂	閂
閃	閃
閆	閆
閉	閉
開	開
閌	閌
閎	閎
閏	閏
閑	閒
閒	閒
間	間
閔	閔
閘	閘
閙	鬧
閡	閡
関	關
閣	閣
閤	合
閥	閥
閨	閨
閩	閩
閫	閫
閬	閬
閭	閭
閱	閱
閲	閱
閶	閶
閹	閹
閻	閻
閼	閼
閽	閽
閾	閾
閿	閿
闃	闃
闆	板
闇	暗
闈	闈
闊	闊
闋	闋
闌	闌
闐	闐
闔	闔
闕	闕
闖	闖
闚	窺
關	關
闞	闞
闡	闡
闢	闢
闥	闥
阨	厄
阬	坑
阯	址
陗	峭
陘	陘
陝	陝
陞	升
陣	陣
陰	陰
陳	陳
陸	陸
陻	堙
陽	陽
隂	陰
隄	堤
隉	隉
隊	隊
階	階
隕	隕
隖	塢
際	際
隣	鄰
隨	隨
險	險
隱	隱
隴	隴
隷	隸
隸	隸
隻	只
雋	雋
雖	雖
雙	雙
雛	雛
雜	雜
雝	雍
雞	雞
離	離
難	難
雰	氛
雲	雲
電	電
霑	沾
霛	靈
霤	溜
霧	霧
霽	霽
靂	靂
靄	靄
靈	靈
靚	靚
靜	靜
靣	面
靦	靦
靨	靨
靭	韌
鞀	鼗
鞉	鼗
鞌	鞍
鞏	鞏
鞦	秋
鞵	鞋
鞽	鞽
鞾	靴
韁	繮
韃	韃
韆	千
韉	韉
韋	韋
韌	韌
韓	韓
韙	韙
韜	韜
韝	鞴
韞	韞
韤	襪
韮	韭
韻	韻
響	響
頁	頁
頂	頂
頃	頃
項	項
順	順
頇	頇
須	須
頊	頊
頌	頌
頎	頎
頏	頏
預	預
頑	頑
頒	頒
頓	頓
頗	頗
領	領
頜	頜
頡	頡
頤	頤
頦	頦
頫	俯
頭	頭
頰	頰
頷	頷
頸	頸
頹	頹
頻	頻
頽	頹
顂	賴
顆	顆
顋	腮
題	題
額	額
顎	顎
顏	顏
顓	顓
顔	顏
願	願
顙	顙
顛	顛
類	類
顢	顢
顥	顥
顦	憔
顧	顧
顫	顫
顬	顬
顯	顯
顰	顰
顱	顱
顳	顳
顴	顴
風	風
颮	颮
颯	颯
颱	臺
颳	刮
颶	颶
颺	揚
颼	颼
颿	帆
飃	飄
飄	飄
飆	飆
飇	飆
飈	飈
飛	飛
飜	翻
飢	飢
飩	飩
飪	飪
飫	飫
飭	飭
飯	飯
飱	飧
飲	飲
飴	飴
飼	飼
飽	飽
飾	飾
餃	餃
餅	餅
餈	餈
餉	餉
養	養
餌	餌
餑	餑
餒	餒
餓	餓
餘	餘
餚	餚
餛	餛
餞	餞
餡	餡
餧	喂
館	館
餬	糊
餱	餱
餳	餳
餵	喂
餷	餷
餹	糖
餻	糕
餼	餼
餽	饋
餾	餾
餿	餿
饃	饃
饅	饅
饈	饈
饉	饉
饊	饊
饋	饋
饌	饌
饍	膳
饑	飢
饒	饒
饗	饗
饜	饜
饝	饃
饞	饞
饢	饢
馬	馬
馭	馭
馮	馮
馱	馱
馳	馳
馴	馴
駁	駁
駐	駐
駑	駑
駒	駒
駔	駔
駕	駕
駘	駘
駙	駙
駛	駛
駝	駝
駟	駟
駡	罵
駢	駢
駭	駭
駮	駁
駱	駱
駿	駿
騁	騁
騅	騅
騍	騍
騎	騎
騏	騏
騐	驗
騖	騖
騗	騙
騙	騙
騣	鬃
騫	騫
騭	騭
騮	騮
騰	騰
騶	騶
騷	騷
騸	騸
騾	騾
驀	驀
驁	驁
驂	驂
驃	驃
驄	驄
驅	驅
驊	驊
驍	驍
驏	驏
驕	驕
驗	驗
驘	騾
驚	驚
驛	驛
驟	驟
驢	驢
驤	驤
驥	驥
驪	驪
骽	腿
骾	鯁
髏	髏
髒	髒
體	體
髕	髕
髖	髖
髣	仿
髩	鬢
髮	發
鬀	剃
鬁	癧
鬆	松
鬉	鬃
鬍	胡
鬚	須
鬢	鬢
鬥	鬥
鬦	鬥
鬧	鬧
鬨	哄
鬩	鬩
鬭	鬥
鬮	鬮
鬱	鬱
魎	魎
魘	魘
魚	魚
魯	魯
魴	魴
魷	魷
鮁	鮁
鮃	鮃
鮌	鯀
鮎	鮎
鮐	鮐
鮑	鮑
鮒	鮒
鮚	鮚
鮞	鮞
鮪	鮪
鮫	鮫
鮭	鮭
鮮	鮮
鯀	鯀
鯁	鯁
鯇	鯇
鯉	鯉
鯊	鯊
鯔	鯔
鯖	鯖
鯗	鯗
鯛	鯛
鯝	鯝
鯡	鯡
鯢	鯢
鯤	鯤
鯧	鯧
鯨	鯨
鯪	鯪
鯫	鯫
鯰	鯰
鯴	鯴
鯽	鯽
鯿	鯿
鰈	鰈
鰉	鰉
鰌	鰍
鰍	鰍
鰐	鱷
鰒	鰒
鰓	鰓
鰠	鰠
鰣	鰣
鰥	鰥
鰨	鰨
鰩	鰩
鰭	鰭
鰱	鰱
鰲	鰲
鰳	鰳
鰵	鰵
鰷	鰷
鰹	鰹
鰻	鰻
鰾	鰾
鱅	鱅
鱈	鱈
鱉	鱉
鱒	鱒
鱓	鱔
鱔	鱔
鱖	鱖
鱗	鱗
鱘	鱘
鱝	鱝
鱟	鱟
鱧	鱧
鱭	鱭
鱷	鱷
鱸	鱸
鱺	鱺
鳥	鳥
鳧	鳧
鳩	鳩
鳳	鳳
鳴	鳴
鳶	鳶
鴆	鴆
鴇	鴇
鴈	雁
鴉	鴉
鴕	鴕
鴛	鴛
鴝	鴝
鴟	鴟
鴣	鴣
鴦	鴦
鴨	鴨
鴯	鴯
鴰	鴰
鴻	鴻
鴿	鴿
鵂	鵂
鵑	鵑
鵒	鵒
鵓	鵓
鵜	鵜
鵝	鵝
鵞	鵝
鵠	鵠
鵡	鵡
鵪	鵪
鵬	鵬
鵯	鵯
鵰	雕
鵲	鵲
鵶	鴉
鶇	鶇
鶉	鶉
鶓	鶓
鶘	鶘
鶚	鶚
鶥	鶥
鶩	鶩
鶯	鶯
鶴	鶴
鶻	鶻
鶼	鶼
鶿	鷀
鷀	鷀
鷂	鷂
鷄	雞
鷓	鷓
鷗	鷗
鷙	鷙
鷚	鷚
鷥	鷥
鷦	鷦
鷯	鷯
鷰	燕
鷲	鷲
鷳	鷳
鷴	鷳
鷸	鷸
鷹	鷹
鷺	鷺
鷼	鷳
鸌	鸌
鸎	鶯
鸕	鸕
鸚	鸚
鸛	鸛
鸝	鸝
鸞	鸞
鹵	滷
鹹	鹹
鹺	鹺
鹼	鹼
鹽	鹽
麅	狍
麐	麟
麗	麗
麞	獐
麤	粗
麥	麥
麩	麩
麪	面
麯	曲
麵	面
麼	麼
黃	黃
黌	黌
點	點
黨	黨
黲	黲
黴	黴
黷	黷
黽	黽
黿	黿
鼃	蛙
鼇	鰲
鼈	鱉
鼉	鼉
鼕	冬
鼴	鼴
齇	齄
齊	齊
齋	齋
齎	齎
齏	齏
齒	齒
齔	齔
齙	齙
齜	齜
齟	齟
齠	齠
齡	齡
齣	出
齦	齦
齧	齧
齪	齪
齬	齬
齲	齲
齶	齶
齷	齷
龍	龍
龐	龐
龔	龔
龕	龕
龜	龜
後	後
