A$	澳元
AED	阿聯酋迪拉姆
ARS	阿根廷比索
AUD	澳元
CAD$	加元
CAD	加元
CHF	瑞士法郎
CNY	人民幣
EUR	歐元成員國
GBP	英鎊
HK＄	港元
HKD	港元
INR	印度盧比
J￥	日元
JPY￥	日元
JPY	日元
KRW	韓元
RUB	俄羅斯盧布
SAR	沙特阿拉伯里亞爾
SEK	瑞典克朗
SGD	新加坡元
THB	泰銖
TRY	土耳其里拉
USD	美元
